        XXXXXXXXX
     XX XX X X XX XX
     
     X X X X X X X X
     
     XXX   X X   XXX
     
     XXX XXX XXX XXX
        XX     XX
     XXXX   X   XXXX
      