        X       X
     XXX   X X   XXX
     
     X X X X X X X X
     XX    X X    XX
      XX  XX XX  XX 
     
         XXX XXX
           X X
     XX  X     X  XX
     