       X X XXX X X 
     XX XX XXX XX XX
     XX           XX
     XXXXXXX XXXXXXX
     XX   XX XX   XX
     XX  XXX XXX  XX
          XX XX
       XXXXX XXXXX
       X  XX XX  X
         XXX XXX
         