       XXX XXX XXX
      XXX       XXX
      XX         XX
      X           X
     X      X      X
     XX           XX
      XX         XX
      XXX       XXX
       XXX XXX XXX
        XXXXXXXXX
        