            X      
           XXX
     X    XXXXX    X
        XX     XX
     X XXX  X  XXX X
        XX     XX
     X    XXXXX    X
           XXX
     X      X      X
     XXXXXXXXXXXXXXX
                  